11111111111111111111111111111111111111111111111111111111111111111111111111111111111111111111111111111111111111111111111111111111111111111111111111111111111111111111111111111111111111111111111111111111111111111
bbbbbbbbbbbbbbbbbbbbbbbbbbbbbbbbbbbbbbbbbbbbbbbbbbbbbbbbbbbbbbbbbbbbbbbbbbbbbbbbbbbbbbbbbbbbbbbbbbbbbbbbbbbbbbbbbbbbbbbbbbbbbbbbbbbbbbbbbbbbbbbbbbbbbbbbbbbbbbbbbbbbbbbbbbbbbbbbbbbbbbbbbbbbbbbbbbbbbbbbbbbbbbbbb
.................................................................................................................................................................................................................
.................................................................................................................................................................................................................
.................................................................................................................................................................................................................
.........................................................................................................f.......................................................................................................
.................................................................................................................................................................................................................
...........................................................................................................................................................c.............c.......................................
.................................................................................................................................................................................................................
.................................................................................................................................................................................................................
....p.....................................................................f......................................................................................................................................
.................................................................................................................................................................................................................
111111111111111111111111111111111111111111111111111111111111111111111111111111111111111111111111111111111111111111111111111111...................................................................................
.................................................................................................................................................................................................................
.................................................................................................................................................................................................................
.................................................................................................................................................................................................................
.........................................................................................................................................1111111111111111111100000000001111111111111111111111....................
.................................................................................................................................................................................................................
.................................................................................................................................................................................................................
.................................................................................................................................................................................................................
...................................................................................................................................................f.............................................................
.................................................................................................................................................................................................................
....................................................................................................................................................................f............................................
.................................................................................................................................................................................................................
.................................................................................................................................................................................................................
...............................................................................................................................................................11111111111111111111111111111111111111111111111111
.................................................................................................................................................................................................................
.................................................................................................................................................................................................................
.................................................................................................................................................................................................................
.................................................................................................................................................................................................................
.................................................................................................................................................................................................................
........................................................................................................................................................................................................g........
.................................................................................................................................................................................................................
..............................................................................................................................................1111111111111111111111111111111111111111111111111111111111111111111
