11111111111111111111111111111111111111111111111111111111111111111111111111111111111111111111111111111111111111111111111111111111111111111111111111111111111111111111111111111111111111111111111111111111111111111
11111111111111111111111111111111111111111111111111111111111111111111111111111111111111111111111111111111111111111111111111111111111111111111111111111111111111111111111111111111111111111111111111111111111111111
11111111111111111111111111111111111111111111111111111111111111111111111111111111111111111111111111111111111111111111111111111111111111111111111111111111111111111111111111111111111111111111111111111111111111111
11111111111111111111111111111111111111111111111111111111111111111111111111111111111111111111111111111111111111111111111111111111111111111111111111111111111111111111111111111111111111111111111111111111111111111
11111111111111111111111111111111111111111111111111111111111111111111111111111111111111111111111111111111111111111111111111111111111111111111111111111111111111111111111111111111111111111111111111111111111111111
11111111111111111111111111111111111111111111111111111111111111111111111111111111111111111111111111111111111111111111111111111111111111111111111111111111111111111111111111111111111111111111111111111111111111111
11111.......................................................................................................................................................................................................11111
11111.......................................................................................................................................................................................................11111
11111.......................................................................................................................................................................................................11111
11111.......................................................................................................................................................................................................11111
11111.......................................................................................................................................................................................................11111
11111.......................................................................................................................................................................................................11111
11111.......................................................................................................................................................................................................11111
11111.......................................................................................................................................................................................................11111
11111.......................................................................................................................................................................................................11111
11111.......................................................................................................................................................................................................11111
11111.......................................................................................................................................................................................................11111
11111.......................................................................................................................................................................................................11111
11111.......................................................................................................................................................................................................11111
11111.......................................................................................................................................................................................................11111
11111.......................................................................................................................................................................................................11111
11111.......................................................................................................................................................................................................11111
11111.......................................................................................................................................................................................................11111
11111.......................................................................................................................................................................................................11111
11111.......................................................................................................................................................................................................11111
11111.......................................................................................................................................................................................................11111
11111.......................................................................................................................................................................................................11111
11111.......................................................................................................................................................................................................11111
11111.............................................................................................................................................................................s.........................11111
11111.......................................................................................................................................................................................................11111
11111....p..................................................................................................................................................................................................11111
11111.......................................................................................................................................................................................................11111
11111.......................................................................................................................................................................................................11111
11111111111111111111111111111111111111111111111111111111111111111111111111111111111111111111111111111111111111111111111111111111111111111111111111111111111111111111111111111111111111111111111111111111111111111
