11111111111111111111111111111111111111111111111111111111111111111111111111111111111111111111111111111111111111111111111111111111111111111111111111111111111111111111111111111111111111111111111111111111111111111
1............................1...........................................................1...........................................................1..........................................................1
1............................1...........................................................1...........................................................1..........................................................1
1............................1...........................................................1...........................................................1..........................................................1
1............................1...........................................................1...........................................................1..........................................................1
1............................1...........................................................1...........................................................1..........................................................1
1d...........................1...........................................................1...........................................................1..........................................................1
11111111111111111111111111111111111111111111111111111111111111110001111100011111100011111111111111111111111110000111111111111111100000111111111111111111111111111111111111111111111111111111111111111111100011111
1............................1..................................................................................................................................................................................1
1............................1..................................................................................................................................................................................1
1............................1..................................................................................................................................................................................1
1............................1..................................................................................................................................................................................1
1............................1..................................................................................................................................................................................1
1............................1....................................................c.......................................................................................................................c.....1
1............................1..................................................................................................................................................................................1
1............................1.....................................................................................................c............................................................................1
1............................1..................................................................................................................................................................................1
1............................1..................................................................................................................................................................................1
1..........h.................1......................................................................................f.........................................f.................................................1
1............................1..................................................................................................................................................................................1
11111111111111111111111111111110000111111111111111111111111111000000000000000111111111000111111111000000000000000111100111111111111111111111111100011111111111111110001111111111111111111111111110000011111111111
1........................................................................................1...........................................................1..........................................................1
1................................l......................................................l1...........................................................1...............l..........................................1
1........................................................................................1...........................................................1..........................................................1
1........................................................................................1...........................................................1..........................................................1
1........................................................................................1...........................................................1..........................................................1
1........................................................................................1...........................................................1..........................................................1
1........................................................................................1...........................................................1..........................................................1
1.............................l11........................................................1...........................................................1..........................................................1
1........................................................................................1...........................................................1..........................................................1
1........................................................................................1...........................................................1.....f.........................................g..........1
1...p................d.....................f.........f.......f...........................1.....................................f........f.......................................................................1
1........................................................................................1......................................................................................................................1
11111111111111111111111111111111111111111111111111111111111111111111111111111111111111111111111111111111111111111111111111111111111111111111111111111111111111111111111111111111111111111111111111111111111111111